00000001
00000010
00000010
00000010
00000010
00000100
01111000
10000000
