01000000
01000000
01000000
01000000
00100000
00010000
00001111
00000000
