01000000
00100000
00100000
00100000
00100000
00011100
00000011
00000000
