10000000
01000000
10000000
01000000
01000000
00100000
00011110
00000001
