10000000
10000000
10000000
10000000
10000000
10000000
01000000
00111111
