01000000
00100000
00100000
00100000
00010000
00001110
00000001
00000000
