00000000
00000000
00111100
01000100
00100100
00111100
00000100
00000000
