01010100
10101010
10000001
10000001
01000001
01000001
01000010
00111100
