00000100
01111110
01000001
11000010
10000010
01000001
00111010
00000100
