01111010
10000101
10000010
01000001
00100010
00100001
01011110
00100000
