00000100
00111010
01000010
01000100
10000010
01001100
00110000
00000000
