00000000
00100100
01011010
00100100
00100100
01011010
00100100
00000000
