00000000
00000000
00100100
00011000
00011000
00100100
00000000
00000000
