00000000
00000100
00111100
00101000
01001100
00110000
00000000
00000000
