00000000
00000000
00000000
00000000
00000011
00000111
00000111
00001111
