00000000
00000000
00000011
00001111
00001100
00001000
00111000
00110000
