00000000
00000000
00000000
00000001
00000110
00001000
00001000
00010000
