00000000
01110000
00101110
00100010
01000010
01010010
00101100
00000000
