00000000
01111110
00100010
00100010
01000010
01100110
00111100
00000000
