00000000
01101110
01010100
00100010
01000010
01000100
00111000
00000000
