00000000
00000000
00011100
00100010
01101100
00010000
00000000
00000000
