10000000
01000000
00100000
00100000
01000000
00100000
00010000
11100000
