01110000
00001000
00000100
00000100
00001000
00000100
00000100
01111000
