10000000
10000000
01000000
01000000
01000000
01000000
00100000
11000000
