00001111
00000011
00000001
00000001
00000001
00000001
00000011
00001111
