00000000
00000000
00010000
00101100
01000010
01000010
10000001
10000001
