00000000
00000000
00000000
00010000
00101100
01000110
11000010
10000001
