00000000
00000000
00010000
00101100
00100010
01000010
10000001
00000000
