00111110
01000001
10000001
10000010
10000001
10000010
01001100
00110000
