00000100
00101010
01010010
00100100
01000100
00101010
00010100
00000000
