00000100
01111010
01000001
10000010
10000010
01000001
00111010
00000100
