00000100
00101110
01010010
00100100
01000100
00101110
00010100
00000000
