00100100
01011010
10000001
01000010
01000010
10000001
01011010
00100100
