01010100
10101010
10000001
10000001
10000001
10000001
10000001
01111110
