00000000
00110100
01001010
01000100
01000100
01011010
00100100
00000000
