00001001
00010110
01100000
10000000
10000000
01000000
10000000
10000000
