00000001
00001110
00110000
01000000
01000000
01000000
10000000
10000000
