00000000
00000111
00001000
00010000
00100000
00100000
01000000
01000000
