00000000
00000011
00001100
00110000
01000000
00100000
01000000
01000000
