00000000
00000011
00001100
00001000
00110000
00110000
01000000
01000000
