01000000
00100000
00010000
00010110
00011010
00000010
00000001
00000000
