01000000
01000000
01000000
00100000
01000000
00100110
00011001
00000000
