00110000
00011000
00011000
00011110
00001111
00000001
00000000
00000000
