00100000
00010000
00010110
00001010
00000010
00000011
00000000
00000000
