00001111
00000111
00000111
00000001
00000000
00000000
00000000
00000000
