00010000
00010000
00001000
00000100
00000011
00000000
00000000
00000000
