01000000
01000000
00100000
00100000
00100110
00011010
00000001
00000000
