10000000
10000000
10000000
01000000
10000000
01000000
00100110
00011001
