00000000
00000000
00111100
00100100
00100100
00111100
00000000
00000000
