00111100
01000010
01000001
01000001
10000001
00000000
00000000
00000000
