00000000
00000000
00000000
00000000
00000000
00010000
00101100
11000011
