00000000
00111100
01000010
01000010
10000001
10000001
00000000
00000000
