00000000
00000000
00000000
00010000
00011100
01100100
10000011
00000000
