11111111
11000011
10000001
10000001
00000000
00000000
00000000
00000000
