00000000
00011000
00100110
01000010
01000001
10000001
10000001
00000000
