00000000
00111000
00101100
01000010
01000001
10000001
10000001
00000000
