10000001
01000010
01000110
00111000
00000000
00000000
00000000
00000000
