00000000
10000001
01000001
01000010
00100110
00110100
00001000
00000000
