00000000
11000011
00100010
00100100
00010100
00001000
00000000
00000000
