10000001
01110110
00001000
00000000
00000000
00000000
00000000
00000000
