00000000
00000000
10000001
01000001
00100010
01100010
00111100
00100000
