00000000
10000001
10000001
01000001
01000010
01010110
00101000
00000000
