10000001
01000110
00111010
00000000
00000000
00000000
00000000
00000000
