00000000
00000000
00000000
00000000
10000001
10000001
10000001
11111111
