00000000
00001000
00111100
00101000
00100100
00111110
00000100
00000000
