00000000
00111100
01000010
10000010
01000010
01000010
00111010
00000100
