00000000
00000000
00100000
01111000
00011000
00001100
00000000
00000000
