00000000
00000000
00000000
00110000
00011000
00000000
00000000
00000000
