00000000
00011110
01100010
01000100
01000010
00100001
01111010
00000100
