00011000
00100100
01000010
10000001
10000001
01000010
00100100
00011000
