10000000
01111110
00000010
00000001
00000010
00000010
00000010
00000001
