11011000
00100100
00000010
00000010
00000010
00000010
00000001
00000001
