00000000
00000000
00000000
00000000
10000000
11100000
11100000
11110000
