00000000
00000000
10000001
10000001
01000010
00100010
00011100
00000000
