00000000
00000000
00000000
00000000
10000001
11000001
11100011
11111111
