10110101
01001010
00000000
00000000
00000000
00000000
00000000
00000000
