00000000
00000000
00000000
10000001
01000001
10000001
01000110
00111000
