00000000
10000001
01000010
01000010
01010100
00101000
00000000
00000000
