00000000
10110101
01011010
00001000
00000000
00000000
00000000
00000000
