00000000
11100111
00010100
00010100
00001000
00000000
00000000
00000000
