11000000
00100000
00010000
00010000
00100000
00010000
00001000
11110000
