01000000
00100000
00010000
00001000
00001000
00010000
00100000
01000000
