01000000
01000000
00100000
00110000
00110000
00100000
00100000
01000000
