01100000
00010000
00001000
00001000
00010000
00001000
00000100
01111000
