01111000
00000100
00000010
00000010
00000010
00000010
00000010
00111100
