00110000
00001100
00000010
00000010
00000010
00000010
00001100
00110000
