00000000
00000111
00001000
00001000
00110000
00100000
01000000
01000000
