00000000
00111110
01100110
01100010
01000110
01100110
01111110
00000000
