11111111
11000001
10000001
10000001
10000001
10000001
10000001
11111111
