00000011
00000100
00001000
00001000
00000100
00000100
00000110
00000001
