00111100
01000000
01000000
00100000
01000000
01000000
00100000
00111100
