00000000
00000000
00000000
00000000
00000001
00000111
00000111
00001111
