00000000
00000011
00000100
00011000
00100000
00100000
01000000
01000000
