00000000
00011110
00100010
01000010
01000110
01001000
01111000
00000000
