00000000
00000000
00011000
00111100
00100100
00101100
00111000
00000000
