11111111
11100001
11000001
10000001
10000001
10000111
10000111
11111111
