00000111
00001000
00010000
00010000
00001000
00001000
00000100
00000011
