11110000
10000000
10000000
11000000
10000000
10000000
10000000
11110000
