00000010
00000010
00000100
00001100
00000110
00000010
00000010
00000010
