01111100
01000000
01000000
00100000
01000000
01000000
01000000
00111000
