00000010
00001100
00010000
00100000
00100000
00011100
00000010
00000010
