00001110
00010000
00100000
00100000
00010000
00010000
00001000
00000110
