00000001
00000010
00000100
00000100
00000010
00000010
00000010
00000001
