00001100
00110000
01000000
01000000
01000000
01000000
00110000
00001100
