00000110
00011000
00100000
01000000
01000000
00100000
00011100
00000010
