00011110
00100000
01100000
00100000
01000000
01000000
00100000
00011110
