00011110
00010000
00100000
00100000
00100000
00100000
00010000
00001110
