00000000
00000000
00001000
00010100
00001000
00000000
00000000
00000000
