00000000
00101010
01010110
01000100
01000010
00100010
00011100
00000000
