00000000
00010100
00101010
01000010
00100010
00011100
00000000
00000000
