00000000
00001000
00110100
01000010
01000100
00101000
00010000
00000000
