00000010
00000010
00000100
00000010
00010100
00101000
11000000
00000000
