00001100
00001100
00011000
01110000
11100000
11000000
00000000
00000000
