00001000
00001000
00111000
01000000
10000000
00000000
00000000
00000000
