00000010
00000010
00000010
00000010
00000010
00111100
11000000
00000000
