00000001
00000001
00000001
00000001
00000001
00000010
00000100
11111000
