00000010
00000010
00000010
00000100
00001000
00010000
11100000
00000000
