11110000
11110000
11100000
10000000
00000000
00000000
00000000
00000000
