00000010
00000010
00000010
00000010
00000100
00001000
11110000
00000000
