00000100
00000100
00000100
00111000
01000000
10000000
00000000
00000000
