00000010
00000010
00000100
00001000
00010000
00100000
11000000
00000000
