00000000
00011000
00100100
01000010
01000010
00100100
00011000
00000000
