00000000
00000000
00011000
00100100
00100100
00011000
00000000
00000000
