00000000
00000000
00011100
00100100
00101000
00110000
00000000
00000000
