00010000
00101100
01000010
10000010
01000001
01000010
01010110
00101000
