00000000
00011000
00100100
01000010
00100010
01000010
00111100
00000000
