01101100
01010010
10000001
10000010
01000001
10010101
01101010
00000000
