00000000
00000000
00000000
00000000
11000000
11100000
11110000
11110000
