00000000
10000000
01110000
00001000
00001100
00000100
00000100
00000010
