00000000
11011000
01100100
00000100
00000100
00000100
00000110
00000010
