00000000
11000000
01111000
00001000
00001100
00000100
00000100
00000010
