10000000
01000000
00111100
00000010
00000100
00000100
00000010
00000001
