00000000
00000000
10000000
11110000
01110000
00011000
00011000
00001100
