00000000
11000000
00100000
00010000
00010000
00010000
00001100
00000010
