00000000
11000000
00110000
00001000
00010000
00010000
00001100
00000010
