00000000
00000000
00000000
11000000
00100000
00010000
00001000
00001000
