00000000
11000000
00111000
00000100
00001000
00001000
00000100
00000010
