11111100
00000010
00000001
00000001
00000001
00000001
00000001
00000001
